312363116
123524241
561XXX312
214135426
616161416
131615121
626413143
651121421
145112134
