312363116
123524241
161541315
214135426
616161416
131615121
626413143
651111451
145112134