111111111
222222222
111111111
111111111
111161111
131111111
121111111
111111111
145111111