312363116
123524241
161541315
214135426
616161416
131615211
626413143
651161451
145112134
40000