135423543
315432435
354351434
423441342
254132451
343524513
153134541
235251352
351435412