111111111
222222222
333333333
111111111
222222222
333333333
111111111
222222222
333333333